Sample	Patient	Tissue
A_N	A	Normal
A_T	A	Tumor
B_N	B	Normal
B_T	B	Tumor
C_N	C	Normal
C_T	C	Tumor
D_N	D	Normal
D_T	D	Tumor
E_N	E	Normal
E_T	E	Tumor
F_N	F	Normal
F_T	F	Tumor
G_N	G	Normal
G_T	G	Tumor
H_N	H	Normal
H_T	H	Tumor
I_N	I	Normal
I_T	I	Tumor
J_N	J	Normal
J_T	J	Tumor
K_N	K	Normal
K_T	K	Tumor
L_N	L	Normal
L_T	L	Tumor
M_N	M	Normal
M_T	M	Tumor
N_N	N	Normal
N_T	N	Tumor
O_N	O	Normal
O_T	O	Tumor
P_N	P	Normal
P_T	P	Tumor
